...........#
..........1.
..........#.
.....3...3..
.....#..11..
.........#..
.1..3#.#.#..
##..##.#.###

TODO: need to encode fixed block constraints!
