............
............
............
............
...24..#.4..
##.###1###..
......2.....
##.###1#####
