............
............
............
............
.21.1.......
.##.##......
........112.
###.#.#.####
