............
............
............
....3.......
..1.#..4....
..#....#...4
..........#4
#1.#########
