............
............
............
............
.......1....
......##....
..2.....1.3.
#3###2.#####
