............
............
............
12..22......
##.####.##..
12..........
####..##...#
#####.##..##
