............
............
............
............
........1...
33....2##...
#...3.1.....
#.#.#####2##
