............
....2.......
24..2.......
##..4.......
###.#.......
##.........4
##......#.##
############

TODO: need to encode fixed block constraints!
