Found a solution in 15 steps.

Step 0:
+---------------------------+
|# # # # # # # # # # # # # #|
| +-+-+-+-+-+-+-+-+-+-+-+-+ |
|#|                       |#|
| + · · · · · · · · · · · + |
|#|                       |#|
| + · · · · · · · · · · · + |
|#|                       |#|
| + · · · · · · · · · · · + |
|#|                       |#|
| + · · · · · · +-+ · · · + |
|#|             |1|       |#|
| + · · · · · +-+-+ · · · + |
|#|           |# #|       |#|
| + · +-+ · · +-+-+-+ +-+ + |
|#|   |2|         |1| |3| |#|
| +-+-+-+-+-+-+ +-+-+-+-+-+ |
|# #|3|# # #|2| |# # # # # #|
| · +-+ · · +-+-+ · · · · · |
|# # # # # # # # # # # # # #|
+---------------------------+

Step 1:
+---------------------------+
|# # # # # # # # # # # # # #|
| +-+-+-+-+-+-+-+-+-+-+-+-+ |
|#|                       |#|
| + · · · · · · · · · · · + |
|#|                       |#|
| + · · · · · · · · · · · + |
|#|                       |#|
| + · · · · · · · · · · · + |
|#|                       |#|
| + · · · · · · +-+ · · · + |
|#|             |1|       |#|
| + · · · · · +-+-+ · · · + |
|#|           |# #|       |#|
| + · · +-+ · +-+-+-+ +-+ + |
|#|     |2|       |1| |3| |#|
| +-+-+-+-+-+-+ +-+-+-+-+-+ |
|# #|3|# # #|2| |# # # # # #|
| · +-+ · · +-+-+ · · · · · |
|# # # # # # # # # # # # # #|
+---------------------------+

Step 2:
+---------------------------+
|# # # # # # # # # # # # # #|
| +-+-+-+-+-+-+-+-+-+-+-+-+ |
|#|                       |#|
| + · · · · · · · · · · · + |
|#|                       |#|
| + · · · · · · · · · · · + |
|#|                       |#|
| + · · · · · · · · · · · + |
|#|                       |#|
| + · · · · · · +-+ · · · + |
|#|             |1|       |#|
| + · · · · · +-+-+ · · · + |
|#|           |# #|       |#|
| + · · · +-+ +-+-+-+ +-+ + |
|#|       |2|     |1| |3| |#|
| +-+-+-+-+-+-+ +-+-+-+-+-+ |
|# #|3|# # #|2| |# # # # # #|
| · +-+ · · +-+-+ · · · · · |
|# # # # # # # # # # # # # #|
+---------------------------+

Step 3:
+---------------------------+
|# # # # # # # # # # # # # #|
| +-+-+-+-+-+-+-+-+-+-+-+-+ |
|#|                       |#|
| + · · · · · · · · · · · + |
|#|                       |#|
| + · · · · · · · · · · · + |
|#|                       |#|
| + · · · · · · · · · · · + |
|#|                       |#|
| + · · · · · · +-+ · · · + |
|#|             |1|       |#|
| + · · · · · +-+-+ · · · + |
|#|           |# #|       |#|
| + · · · +-+ +-+-+-+ +-+ + |
|#|       |2|     |1| |3| |#|
| +-+-+-+-+-+ +-+-+-+-+-+-+ |
|# #|3|# # #| |2|# # # # # #|
| · +-+ · · +-+-+ · · · · · |
|# # # # # # # # # # # # # #|
+---------------------------+

Step 4:
+---------------------------+
|# # # # # # # # # # # # # #|
| +-+-+-+-+-+-+-+-+-+-+-+-+ |
|#|                       |#|
| + · · · · · · · · · · · + |
|#|                       |#|
| + · · · · · · · · · · · + |
|#|                       |#|
| + · · · · · · · · · · · + |
|#|                       |#|
| + · · · · · · +-+ · · · + |
|#|             |1|       |#|
| + · · · · · +-+-+ · · · + |
|#|           |# #|       |#|
| + · · · · · +-+-+-+ +-+ + |
|#|               |1| |3| |#|
| +-+-+-+-+-+-+-+-+-+-+-+-+ |
|# #|3|# # #|2 2|# # # # # #|
| · +-+ · · +-+-+ · · · · · |
|# # # # # # # # # # # # # #|
+---------------------------+

Step 5:
+---------------------------+
|# # # # # # # # # # # # # #|
| +-+-+-+-+-+-+-+-+-+-+-+-+ |
|#|                       |#|
| + · · · · · · · · · · · + |
|#|                       |#|
| + · · · · · · · · · · · + |
|#|                       |#|
| + · · · · · · · · · · · + |
|#|                       |#|
| + · · · · · · +-+ · · · + |
|#|             |1|       |#|
| + · · · · · +-+-+ · · · + |
|#|           |# #|       |#|
| + · · · · · +-+-+-+-+ · + |
|#|               |1|3|   |#|
| +-+-+-+-+-+-+-+-+-+-+-+-+ |
|# #|3|# # #|2 2|# # # # # #|
| · +-+ · · +-+-+ · · · · · |
|# # # # # # # # # # # # # #|
+---------------------------+

Step 6:
+---------------------------+
|# # # # # # # # # # # # # #|
| +-+-+-+-+-+-+-+-+-+-+-+-+ |
|#|                       |#|
| + · · · · · · · · · · · + |
|#|                       |#|
| + · · · · · · · · · · · + |
|#|                       |#|
| + · · · · · · · · · · · + |
|#|                       |#|
| + · · · · · · +-+ · · · + |
|#|             |1|       |#|
| + · · · · · +-+-+ · · · + |
|#|           |# #|       |#|
| + · · · · · +-+-+-+ · · + |
|#|             |1|3|     |#|
| +-+-+-+-+-+-+-+-+-+-+-+-+ |
|# #|3|# # #|2 2|# # # # # #|
| · +-+ · · +-+-+ · · · · · |
|# # # # # # # # # # # # # #|
+---------------------------+

Step 7:
+---------------------------+
|# # # # # # # # # # # # # #|
| +-+-+-+-+-+-+-+-+-+-+-+-+ |
|#|                       |#|
| + · · · · · · · · · · · + |
|#|                       |#|
| + · · · · · · · · · · · + |
|#|                       |#|
| + · · · · · · · · · · · + |
|#|                       |#|
| + · · · · · · +-+ · · · + |
|#|             |1|       |#|
| + · · · · · +-+-+ · · · + |
|#|           |# #|       |#|
| + · · · · · +-+-+ · · · + |
|#|           |1|3|       |#|
| +-+-+-+-+-+-+-+-+-+-+-+-+ |
|# #|3|# # #|2 2|# # # # # #|
| · +-+ · · +-+-+ · · · · · |
|# # # # # # # # # # # # # #|
+---------------------------+

Step 8:
+---------------------------+
|# # # # # # # # # # # # # #|
| +-+-+-+-+-+-+-+-+-+-+-+-+ |
|#|                       |#|
| + · · · · · · · · · · · + |
|#|                       |#|
| + · · · · · · · · · · · + |
|#|                       |#|
| + · · · · · · · · · · · + |
|#|                       |#|
| + · · · · · · +-+ · · · + |
|#|             |1|       |#|
| + · · · · · +-+-+ · · · + |
|#|           |# #|       |#|
| + · · · · +-+-+-+ · · · + |
|#|         |1|3|         |#|
| +-+-+-+-+-+-+-+-+-+-+-+-+ |
|# #|3|# # #|2 2|# # # # # #|
| · +-+ · · +-+-+ · · · · · |
|# # # # # # # # # # # # # #|
+---------------------------+

Step 9:
+---------------------------+
|# # # # # # # # # # # # # #|
| +-+-+-+-+-+-+-+-+-+-+-+-+ |
|#|                       |#|
| + · · · · · · · · · · · + |
|#|                       |#|
| + · · · · · · · · · · · + |
|#|                       |#|
| + · · · · · · · · · · · + |
|#|                       |#|
| + · · · · · +-+ · · · · + |
|#|           |1|         |#|
| + · · · · · +-+-+ · · · + |
|#|           |# #|       |#|
| + · · · · +-+-+-+ · · · + |
|#|         |1|3|         |#|
| +-+-+-+-+-+-+-+-+-+-+-+-+ |
|# #|3|# # #|2 2|# # # # # #|
| · +-+ · · +-+-+ · · · · · |
|# # # # # # # # # # # # # #|
+---------------------------+

Step 10:
+---------------------------+
|# # # # # # # # # # # # # #|
| +-+-+-+-+-+-+-+-+-+-+-+-+ |
|#|                       |#|
| + · · · · · · · · · · · + |
|#|                       |#|
| + · · · · · · · · · · · + |
|#|                       |#|
| + · · · · · · · · · · · + |
|#|                       |#|
| + · · · · · · · · · · · + |
|#|                       |#|
| + · · · · +-+-+-+ · · · + |
|#|         |1|# #|       |#|
| + · · · · + +-+-+ · · · + |
|#|         |1|3|         |#|
| +-+-+-+-+-+-+-+-+-+-+-+-+ |
|# #|3|# # #|2 2|# # # # # #|
| · +-+ · · +-+-+ · · · · · |
|# # # # # # # # # # # # # #|
+---------------------------+

Step 11:
+---------------------------+
|# # # # # # # # # # # # # #|
| +-+-+-+-+-+-+-+-+-+-+-+-+ |
|#|                       |#|
| + · · · · · · · · · · · + |
|#|                       |#|
| + · · · · · · · · · · · + |
|#|                       |#|
| + · · · · · · · · · · · + |
|#|                       |#|
| + · · · · · · · · · · · + |
|#|                       |#|
| + · · · +-+ +-+-+ · · · + |
|#|       |1| |# #|       |#|
| + · · · + +-+-+-+ · · · + |
|#|       |1|3|           |#|
| +-+-+-+-+-+-+-+-+-+-+-+-+ |
|# #|3|# # #|2 2|# # # # # #|
| · +-+ · · +-+-+ · · · · · |
|# # # # # # # # # # # # # #|
+---------------------------+

Step 12:
+---------------------------+
|# # # # # # # # # # # # # #|
| +-+-+-+-+-+-+-+-+-+-+-+-+ |
|#|                       |#|
| + · · · · · · · · · · · + |
|#|                       |#|
| + · · · · · · · · · · · + |
|#|                       |#|
| + · · · · · · · · · · · + |
|#|                       |#|
| + · · · · · · · · · · · + |
|#|                       |#|
| + · · +-+ · +-+-+ · · · + |
|#|     |1|   |# #|       |#|
| + · · + +-+ +-+-+ · · · + |
|#|     |1|3|             |#|
| +-+-+-+-+-+-+-+-+-+-+-+-+ |
|# #|3|# # #|2 2|# # # # # #|
| · +-+ · · +-+-+ · · · · · |
|# # # # # # # # # # # # # #|
+---------------------------+

Step 13:
+---------------------------+
|# # # # # # # # # # # # # #|
| +-+-+-+-+-+-+-+-+-+-+-+-+ |
|#|                       |#|
| + · · · · · · · · · · · + |
|#|                       |#|
| + · · · · · · · · · · · + |
|#|                       |#|
| + · · · · · · · · · · · + |
|#|                       |#|
| + · · · · · · · · · · · + |
|#|                       |#|
| + · +-+ · · +-+-+ · · · + |
|#|   |1|     |# #|       |#|
| + · + +-+ · +-+-+ · · · + |
|#|   |1|3|               |#|
| +-+-+-+-+-+-+-+-+-+-+-+-+ |
|# #|3|# # #|2 2|# # # # # #|
| · +-+ · · +-+-+ · · · · · |
|# # # # # # # # # # # # # #|
+---------------------------+

Step 14:
+---------------------------+
|# # # # # # # # # # # # # #|
| +-+-+-+-+-+-+-+-+-+-+-+-+ |
|#|                       |#|
| + · · · · · · · · · · · + |
|#|                       |#|
| + · · · · · · · · · · · + |
|#|                       |#|
| + · · · · · · · · · · · + |
|#|                       |#|
| + · · · · · · · · · · · + |
|#|                       |#|
| + +-+ · · · +-+-+ · · · + |
|#| |1|       |# #|       |#|
| + + +-+ · · +-+-+ · · · + |
|#| |1|3|                 |#|
| +-+-+-+-+-+-+-+-+-+-+-+-+ |
|# #|3|# # #|2 2|# # # # # #|
| · +-+ · · +-+-+ · · · · · |
|# # # # # # # # # # # # # #|
+---------------------------+

Step 15:
+---------------------------+
|# # # # # # # # # # # # # #|
| +-+-+-+-+-+-+-+-+-+-+-+-+ |
|#|                       |#|
| + · · · · · · · · · · · + |
|#|                       |#|
| + · · · · · · · · · · · + |
|#|                       |#|
| + · · · · · · · · · · · + |
|#|                       |#|
| + · · · · · · · · · · · + |
|#|                       |#|
| +-+ · · · · +-+-+ · · · + |
|#|1|         |# #|       |#|
| + +-+ · · · +-+-+ · · · + |
|#|1|3|                   |#|
| +-+ +-+-+-+-+-+-+-+-+-+-+ |
|# #|3|# # #|2 2|# # # # # #|
| · +-+ · · +-+-+ · · · · · |
|# # # # # # # # # # # # # #|
+---------------------------+
